species	tribe
Aegialomys_galapagoensis	Oryzomyini
Aegialomys_xanthaeolus	Oryzomyini
Aepeomys_lugens	Thomasomyini
Akodon_aerosus	Akodontini
Akodon_affinis	Akodontini
Akodon_albiventer	Akodontini
Akodon_azarae	Akodontini
Akodon_boliviensis	Akodontini
Akodon_budini	Akodontini
Akodon_caenosus	Akodontini
Akodon_cursor	Akodontini
Akodon_dayi	Akodontini
Akodon_dolores	Akodontini
Akodon_fumeus	Akodontini
Akodon_iniscatus	Akodontini
Akodon_juninensis	Akodontini
Akodon_kofordi	Akodontini
Akodon_lindberghi	Akodontini
Akodon_lutescens	Akodontini
Akodon_mimus	Akodontini
Akodon_mollis	Akodontini
Akodon_montensis	Akodontini
Akodon_mystax	Akodontini
Akodon_orophilus	Akodontini
Akodon_paranaensis	Akodontini
Akodon_reigi	Akodontini
Akodon_sanctipaulensis	Akodontini
Akodon_serrensis	Akodontini
Akodon_siberiae	Akodontini
Akodon_simulator	Akodontini
Akodon_simulator_	Akodontini
Akodon_spegazzinii	Akodontini
Akodon_subfuscus	Akodontini
Akodon_surdus	Akodontini
Akodon_sylvanus	Akodontini
Akodon_toba	Akodontini
Akodon_torques	Akodontini
Akodon_varius	Akodontini
Andalgalomys_pearsoni	Phyllotini
Auliscomys_boliviensis	Phyllotini
Auliscomys_pictus	Phyllotini
Auliscomys_sublimis	Phyllotini
Blarinomys_breviceps	Akodontini
Brucepattersonius_iheringi	Akodontini
Brucepattersonius_soricinus	Akodontini
Brucepattersonius_sp	Akodontini
Calomys_callosus	Phyllotini
Calomys_laucha	Phyllotini
Calomys_lepidus	Phyllotini
Calomys_musculinus	Phyllotini
Calomys_sorellus	Phyllotini
Calomys_venustus	Phyllotini
Cerradomys_langguthi	Oryzomyini
Cerradomys_maracajuensis	Oryzomyini
Cerradomys_scotti	Oryzomyini
Chilomys_instans	Thomasomyini
Deltamys_kempi	Akodontini
Eligmodontia_morgani	Phyllotini
Eremoryzomys_polius	Oryzomyini
Euryoryzomys_legatus	Oryzomyini
Euryoryzomys_macconnelli	Oryzomyini
Euryoryzomys_nitidus	Oryzomyini
Euryoryzomys_russatus	Oryzomyini
Galenomys_garleppii	Phyllotini
Graomys_domorum	Phyllotini
Graomys_griseoflavus	Phyllotini
Handleyomys_alfaroi	Oryzomyini
Handleyomys_intectus	Oryzomyini
Holochilus_brasiliensis	Oryzomyini
Holochilus_sciureus	Oryzomyini
Hylaeamys_megacephalus	Oryzomyini
Hylaeamys_oniscus	Oryzomyini
Hylaeamys_perenensis	Oryzomyini
Hylaeamys_yunganus	Oryzomyini
Juscelinomys_huanchacae	Akodontini
Kunsia_tomentosus	Akodontini
Lenoxus_apicalis	Akodontini
Loxodontomys_micropus	Phyllotini
Lundomys_molitor	Oryzomyini
Melanomys_caliginosus	Oryzomyini
Melanomys_robustulus	Oryzomyini
Melanomys_zunigae	Oryzomyini
Microryzomys_altissimus	Oryzomyini
Microryzomys_minutus	Oryzomyini
Neacomys_guianae	Oryzomyini
Neacomys_spinosus	Oryzomyini
Neacomys_tenuipes	Oryzomyini
Necromys_amoenus	Akodontini
Necromys_lactens	Akodontini
Necromys_lasiurus	Akodontini
Necromys_lenguarum	Akodontini
Necromys_obscurus	Akodontini
Necromys_urichi	Akodontini
Nectomys_apicalis	Oryzomyini
Nectomys_palmipes	Oryzomyini
Nectomys_rattus	Oryzomyini
Nectomys_squamipes	Oryzomyini
Nephelomys_albigularis	Oryzomyini
Nephelomys_auriventer	Oryzomyini
Nephelomys_devius	Oryzomyini
Nephelomys_keaysi	Oryzomyini
Nephelomys_levipes	Oryzomyini
Nephelomys_maculiventer	Oryzomyini
Nephelomys_meridensis	Oryzomyini
Nephelomys_moerex	Oryzomyini
Nephelomys_pectoralis	Oryzomyini
Nephelomys_pirrensis	Oryzomyini
Nesoryzomys_darwini	Oryzomyini
Nesoryzomys_fernandinae	Oryzomyini
Nesoryzomys_indefessus	Oryzomyini
Nesoryzomys_swarthi	Oryzomyini
Oecomys_bicolor	Oryzomyini
Oecomys_concolor	Oryzomyini
Oecomys_flavicans	Oryzomyini
Oecomys_mamorae	Oryzomyini
Oecomys_paricola	Oryzomyini
Oecomys_phaeotis	Oryzomyini
Oecomys_roberti	Oryzomyini
Oecomys_speciosus	Oryzomyini
Oecomys_superans	Oryzomyini
Oecomys_trinitatis	Oryzomyini
Oligoryzomys_andinus	Oryzomyini
Oligoryzomys_arenalis	Oryzomyini
Oligoryzomys_chacoensis	Oryzomyini
Oligoryzomys_destructor	Oryzomyini
Oligoryzomys_flavescens	Oryzomyini
Oligoryzomys_fulvescens	Oryzomyini
Oligoryzomys_griseolus	Oryzomyini
Oligoryzomys_longicaudatus	Oryzomyini
Oligoryzomys_magellanicus	Oryzomyini
Oligoryzomys_microtis	Oryzomyini
Oligoryzomys_nigripes	Oryzomyini
Oligoryzomys_vegetus	Oryzomyini
Oreoryzomys_balneator	Oryzomyini
Oryzomys_couesi	Oryzomyini
Oryzomys_palustris	Oryzomyini
Oxymycterus_dasytrichus	Akodontini
Oxymycterus_delator	Akodontini
Oxymycterus_inca	Akodontini
Oxymycterus_nasutus	Akodontini
Oxymycterus_paramensis	Akodontini
Oxymycterus_quaestor	Akodontini
Oxymycterus_rufus	Akodontini
Phyllotis_amicus	Phyllotini
Phyllotis_andium	Phyllotini
Phyllotis_caprinus	Phyllotini
Phyllotis_darwini	Phyllotini
Phyllotis_definitus	Phyllotini
Phyllotis_gerbillus	Phyllotini
Phyllotis_haggardi	Phyllotini
Phyllotis_limatus	Phyllotini
Phyllotis_magister	Phyllotini
Phyllotis_osilae	Phyllotini
Phyllotis_xanthopygus	Phyllotini
Podoxymys_roraimae	Akodontini
Pseudoryzomys_simplex	Oryzomyini
Rhagomys_longilingua	Thomasomyini
Rhipidomys_austrinus	Thomasomyini
Rhipidomys_caucensis	Thomasomyini
Rhipidomys_fulviventer	Thomasomyini
Rhipidomys_latimanus	Thomasomyini
Rhipidomys_leucodactylus	Thomasomyini
Rhipidomys_macconnelli	Thomasomyini
Rhipidomys_macrurus	Thomasomyini
Rhipidomys_mastacalis	Thomasomyini
Rhipidomys_modicus	Thomasomyini
Rhipidomys_venezuelae	Thomasomyini
Rhipidomys_venustus	Thomasomyini
Scapteromys_aquaticus	Akodontini
Scapteromys_tumidus	Akodontini
Scolomys_melanops	Oryzomyini
Sigmodontomys_alfari	Oryzomyini
Sooretamys_angouya	Oryzomyini
Thalpomys_lasiotis	Akodontini
Thaptomys_nigrita	Akodontini
Thomasomys_aureus	Thomasomyini
Thomasomys_baeops	Thomasomyini
Thomasomys_cinereiventer	Thomasomyini
Thomasomys_cinereus	Thomasomyini
Thomasomys_daphne	Thomasomyini
Thomasomys_gracilis	Thomasomyini
Thomasomys_hylophilus	Thomasomyini
Thomasomys_incanus	Thomasomyini
Thomasomys_ischyrus	Thomasomyini
Thomasomys_ischyurus	Thomasomyini
Thomasomys_kalinowskii	Thomasomyini
Thomasomys_laniger	Thomasomyini
Thomasomys_monochromos	Thomasomyini
Thomasomys_niveipes	Thomasomyini
Thomasomys_notatus	Thomasomyini
Thomasomys_oreas	Thomasomyini
Thomasomys_paramorum	Thomasomyini
Thomasomys_pyrrhonotus	Thomasomyini
Thomasomys_taczanowskii	Thomasomyini
Thomasomys_vulcani	Thomasomyini
Transandinomys_bolivaris	Oryzomyini
Transandinomys_talamancae	Oryzomyini
Zygodontomys_brevicauda	Oryzomyini
Zygodontomys_brunneus	Oryzomyini
